15.oX
...............
.oo............
.o...........o.
..........o....
..............o
...............
o.........o....
......o........
...............
...o...........
...............
...............
...............
......o.....o..
...............
