15.oX
...............
o..........o...
.o.....o.......
......oo.......
....o..o.......
...............
..o........o.oo
o..............
.....o.........
...............
oo.............
..o.......o....
.............oo
o.....o........
.....o..o......
