15.oX
.......oo......
.o..oo.o.......
........oo.....
....oo...o.o...
...........oo..
.o.ooo.o.o.....
o.o..o.........
..o....o..o....
.o.oo.....o....
..............o
o...........ooo
.....o.o.......
.oo.o....o...o.
............o.o
.........o.....
