15.oX
...o..........o
o...oo.oo..o...
.......ooo.o...
oo.....o.....o.
.o...o.oo...o..
....o....ooo..o
o.....o.o..oo..
oo.o....o..o...
o.......o...o..
........o....o.
........o.o....
...o.o..o...o.o
o...o...oo....o
..ooo..oo......
oo..o.........o
