15.oX
.oo..o.oo.o..o.
.o....o........
.o....o........
.o..oo..o.o....
o........o...o.
o....oo.o......
.o....o........
o..o....o..o...
....o.....o....
.o.o...o...oo..
...oo..o.o.o...
............ooo
..o...o.ooo....
......o.....o..
...o...o.......
